
000000000000000000000000000000000000000000
000000000000000000000000000000000000000000
000000000000000000000000000000000000000000
000000000000000000000000000000000000000000
000000011110000000000000000000000000000000
000000000000000000000000000000000000000000
000000000000011110000000000111111000000000
111111111111122221111000000222222220000000
222222222222222222222000002222200000000000
222222222222222222222000000000000000000000
222222222222222222222000000000000000000000
222222222222222222222000000000000000000000
222222222222222222222000000000000000000000